00000000000000000000000000000000000
00000000000000000000000000000000000
00000000000000000000000000000000000
00000000000000000000000000000000000
00000000000000000000000000000000000
00000000000000000000000000000000000
00000000000000000000000000000000000
00000000000000000000000000000000000
00000000000000000000000000000000000
00000000000000000000000000000000000
00000000000000000000000000000000000
00000000000000000000000000000000000
00000000000000000000000000000000000
00000000000000001000000000000010000
00000000000000011101000000000011000
00000000000000111001000000000111000
00000000000000011001000000001111000
00000000000000111010000000011111000
00000000100000111110000000111111100
00001001100001111110000001111111000
00001001110111111110000001111111000
00011011111111111110000011111111000
00001011111111111111000011111111000
00011011111111111111000111111100000
00001101111111111111111111000000000
00011111111111111111111110000000000
00001111111111111111111110000000000
00001111111111111111111100000000000
00000111111111111111111100000000000
00001111111111111111111000000000000
00001111111111111111111100000000000
00001111111111111111111000000000000
00001111111111111111111111111100000
00001111111111111111111111111100000
00001111111111111111111111111110000
00001111111111111111111111111100000
00001111111111111111111111111110000
00001111111111111111111111111100000
00001111111111111111111111111110000
00001111111111111111111111111100000
00001111111111111111111111111110000
00001111111111111111111000001100000
00001111111111111111111000001110000
00001111111111111111110000001110000
00001111111111111111110000001110000
00001111111111111111000000001110000
00000111111111111111000000001110000
00000111111111111100000000001110000
00000011111111111100000000001110000
00000011111111111000000000001110000
00000011111111111000000000001110000
00000011111111111000000000001110000
00000011111111111000000000001110000
00000011111111110000000000001110000
00000001111111110000000000001110000
00000011111111100000000000001110000
00000001111111100000000000001110000
00000001111111000000000000001110000
00000000111111000000000000000111000
00000000111110000000000000000111000
00000000011100000000000000000011100
00000000011000000000000000000111100
00000000011000000000000100000111110
00000000111000000000000100001111110
00000000011000000000000110001111111
00000000111000000000000110011111110
00000000011000000000000111011111111
00000000111000000000001111111111110
00000000111000000000001111111111111
00000000111000000000011111111111110
00000000111000000000011111111111111
00000000111000000000011111111111110
00000000111000000000011111111111111
00000000111000000000011111111111110
00000100111000000000011111111111111
00001111111000000000111111111111110
00001111111000000000111111111111111
00011111111000000001111111111111110
00001111111000000001111111111111111
00011110111000000011111111111111110
00001111111100000011111111111111111
00011111111100000110111111111111110
00001011111110000010011111111111111
00011111111110001110101111111111110
00001111111111111110110000111001100
00011111111111111100100000000000000
00001111111111111110110000000000000
00011111111111111100100000000000000
00001111111111111100000000000000000
---